800000003
500800704
000000060
060980100
007000400
008061090
050000000
302004008
100000005