11111111111111111111111
10000000001111111111001
10000000001111111111001
10000000001121111111001
10000000001121111111001
10000000000000000000001
10000000000000000000001
10000000000000000000001
10000000000000000000001
10000000000000000000331
10000000000000000000331
10000000000000000000331
10000000000000000000331
10000000000000000000001
10000000000000000000441
10000000000000000000441
10000000000000000000441
11100000000000000000441
11100000000000000000001
11111111111110000000551
11111111111111000000551
11111111111111000000551
11111111111111111111111